6 -1 1 1 -1 4 -1 0 0 0 0 0 0 0 0 0 0 
7 1 -1 -1 0 0 0 0 0 0 0 0 0 0 0 0 0 
7 1 -1 -1 -1 2 1 0 0 0 0 0 0 0 0 0 0 
5 1 -2 1 -1 -1 -1 2 1 3 -2 2 0 0 0 0 0 
3 3 -1 1 -5 0 0 0 0 0 0 0 0 0 0 0 0 
3 1 -1 -1 2 0 0 0 0 0 0 0 0 0 0 0 0 
8 2 -4 -3 1 1 -1 3 9 1 2 -12 0 0 0 0 0 
8 -1 -2 -1 2 3 -1 3 -5 -6 0 0 0 0 0 0 0 
8 -1 1 -1 2 -1 -29 0 0 0 0 0 0 0 0 0 0 
9 1 2 1 -2 4 -4 4 -9 11 0 0 0 0 0 0 0 
3 1 -1 -1 0 0 0 0 0 0 0 0 0 0 0 0 0 
5 -1 -1 -1 0 0 0 0 0 0 0 0 0 0 0 0 0 
10 1 -1 -3 -1 3 -3 5 -1 5 -10 -2 1 0 0 0 0 
11 -1 -1 -1 -1 2 2 -1 3 11 2 0 0 0 0 0 0 
8 1 2 -2 0 0 0 0 0 0 0 0 0 0 0 0 0 
7 1 1 2 2 0 0 0 0 0 0 0 0 0 0 0 0 
-2 0 0 0 0 0 0 0 0 0 0 0 0 0 0 0 0 
-2 0 0 0 0 0 0 0 0 0 0 0 0 0 0 0 0 
1 0 0 0 0 0 0 0 0 0 0 0 0 0 0 0 0 
0 1 -1 -1 0 0 0 0 0 0 0 0 0 0 0 0 0 
1 1 1 -1 0 0 0 0 0 0 0 0 0 0 0 0 0 
2 2 1 -1 0 0 0 0 0 0 0 0 0 0 0 0 0 
0 1 1 -1 0 0 0 0 0 0 0 0 0 0 0 0 0 
1 -1 1 -1 0 0 0 0 0 0 0 0 0 0 0 0 0 
1 -1 1 -1 0 0 0 0 0 0 0 0 0 0 0 0 0 
2 -1 -1 -1 0 0 0 0 0 0 0 0 0 0 0 0 0 
