8 -1 1 -1 -2 0 0 0 0 0 0 0 0 0 0 0 0 
5 1 1 1 2 -2 -3 0 0 0 0 0 0 0 0 0 0 
5 1 -4 -1 4 1 -3 2 2 -3 -1 1 0 0 0 0 0 
9 1 1 -2 -2 1 0 0 0 0 0 0 0 0 0 0 0 
5 -1 -1 -1 1 0 0 0 0 0 0 0 0 0 0 0 0 
6 1 -1 2 -1 0 0 0 0 0 0 0 0 0 0 0 0 
5 -1 -1 1 0 0 0 0 0 0 0 0 0 0 0 0 0 
4 -1 -1 -1 0 0 0 0 0 0 0 0 0 0 0 0 0 
9 2 -3 1 -1 2 -3 2 2 4 -4 0 0 0 0 0 0 
8 -1 -1 3 -2 0 0 0 0 0 0 0 0 0 0 0 0 
6 -1 1 2 1 2 4 1 -5 -2 -2 -7 -7 5 0 0 0 
9 1 1 1 1 1 -3 0 0 0 0 0 0 0 0 0 0 
4 -1 1 -1 1 -2 0 0 0 0 0 0 0 0 0 0 0 
4 -1 1 1 -1 0 0 0 0 0 0 0 0 0 0 0 0 
6 1 1 -2 0 0 0 0 0 0 0 0 0 0 0 0 0 
4 -1 -1 -1 2 1 0 0 0 0 0 0 0 0 0 0 0 
