5 -2 -4 2 2 -4 0 0 0 0 0 0 0 0 0 0 0 
7 1 1 -1 -1 -1 -2 2 0 0 0 0 0 0 0 0 0 
6 -2 -1 -1 -1 -1 1 5 0 0 0 0 0 0 0 0 0 
7 1 1 -2 2 -3 12 2 -1 -2 -5 0 0 0 0 0 0 
8 2 1 3 0 0 0 0 0 0 0 0 0 0 0 0 0 
4 2 -4 1 0 0 0 0 0 0 0 0 0 0 0 0 0 
7 -1 1 2 -2 3 0 0 0 0 0 0 0 0 0 0 0 
4 1 1 1 0 0 0 0 0 0 0 0 0 0 0 0 0 
5 -1 -1 1 6 0 0 0 0 0 0 0 0 0 0 0 0 
7 1 -2 1 3 -3 3 0 0 0 0 0 0 0 0 0 0 
6 -1 1 -2 -2 0 0 0 0 0 0 0 0 0 0 0 0 
5 -1 1 1 -1 -1 3 1 0 0 0 0 0 0 0 0 0 
6 1 -2 2 1 -4 2 -9 4 0 0 0 0 0 0 0 0 
5 1 1 -4 0 0 0 0 0 0 0 0 0 0 0 0 0 
8 2 1 -1 1 2 -4 1 -6 1 0 0 0 0 0 0 0 
6 1 -1 -1 -1 2 0 0 0 0 0 0 0 0 0 0 0 
-2 -1 1 1 0 0 0 0 0 0 0 0 0 0 0 0 0 
-2 0 0 0 0 0 0 0 0 0 0 0 0 0 0 0 0 
0 0 0 0 0 0 0 0 0 0 0 0 0 0 0 0 0 
0 0 0 0 0 0 0 0 0 0 0 0 0 0 0 0 0 
0 -1 1 -1 0 0 0 0 0 0 0 0 0 0 0 0 0 
1 1 -1 -1 0 0 0 0 0 0 0 0 0 0 0 0 0 
0 0 0 0 0 0 0 0 0 0 0 0 0 0 0 0 0 
0 0 0 0 0 0 0 0 0 0 0 0 0 0 0 0 0 
0 0 0 0 0 0 0 0 0 0 0 0 0 0 0 0 0 
0 0 0 0 0 0 0 0 0 0 0 0 0 0 0 0 0 
