9 -1 -1 1 -1 3 0 0 0 0 0 0 0 0 0 0 0 
4 1 2 -1 0 0 0 0 0 0 0 0 0 0 0 0 0 
5 1 1 -2 2 -1 -1 -1 -2 -3 -2 3 -3 4 5 1 0 
9 -1 1 -1 -1 -1 2 0 0 0 0 0 0 0 0 0 0 
5 1 -2 -1 0 0 0 0 0 0 0 0 0 0 0 0 0 
5 -1 -1 1 3 1 -2 4 0 0 0 0 0 0 0 0 0 
4 1 -1 3 -1 2 -2 1 0 0 0 0 0 0 0 0 0 
7 -1 2 -1 4 -1 1 -5 -2 3 0 0 0 0 0 0 0 
12 1 -1 2 -3 -1 4 3 -3 -2 -1 0 0 0 0 0 0 
8 -1 1 -1 -1 -2 4 1 2 0 0 0 0 0 0 0 0 
8 -1 1 2 3 -1 -3 -2 -3 0 0 0 0 0 0 0 0 
8 1 1 -1 2 1 6 0 0 0 0 0 0 0 0 0 0 
8 1 -1 -1 -1 4 1 3 -1 2 -3 0 0 0 0 0 0 
10 1 -1 -1 -5 -1 6 1 10 -13 0 0 0 0 0 0 0 
8 1 -2 -2 -1 -1 1 2 -2 5 -1 0 0 0 0 0 0 
10 2 1 -2 -1 4 -1 -4 -1 -6 -4 0 0 0 0 0 0 
-2 1 -1 1 0 0 0 0 0 0 0 0 0 0 0 0 0 
-2 1 -1 -1 0 0 0 0 0 0 0 0 0 0 0 0 0 
