5 -1 -1 -5 1 10 0 0 0 0 0 0 0 0 0 0 0 
5 1 3 1 2 -2 -2 -6 0 0 0 0 0 0 0 0 0 
7 2 -1 -8 -1 13 3 2 -2 -2 0 0 0 0 0 0 0 
8 -1 -1 1 2 -3 1 3 -5 6 2 0 0 0 0 0 0 
5 2 -1 3 1 0 0 0 0 0 0 0 0 0 0 0 0 
5 -1 1 -2 1 1 -2 3 -1 0 0 0 0 0 0 0 0 
7 -1 1 1 -1 -1 -2 1 0 0 0 0 0 0 0 0 0 
8 -1 -2 1 3 0 0 0 0 0 0 0 0 0 0 0 0 
10 -1 1 -1 1 2 -1 4 1 1 -4 4 -5 -3 5 0 0 
12 1 -1 3 -2 8 2 2 1 -5 -3 -4 1 0 0 0 0 
9 -1 1 -1 -2 25 0 0 0 0 0 0 0 0 0 0 0 
9 1 -1 -2 0 0 0 0 0 0 0 0 0 0 0 0 0 
10 -1 1 -1 1 -2 8 2 -2 -2 3 -4 -1 0 0 0 0 
8 1 -2 -1 -2 5 3 -3 -6 -1 0 0 0 0 0 0 0 
8 -1 -1 1 0 0 0 0 0 0 0 0 0 0 0 0 0 
6 -1 2 -1 2 -1 0 0 0 0 0 0 0 0 0 0 0 
-2 1 -1 1 0 0 0 0 0 0 0 0 0 0 0 0 0 
-2 -1 1 1 0 0 0 0 0 0 0 0 0 0 0 0 0 
1 -1 1 -1 0 0 0 0 0 0 0 0 0 0 0 0 0 
2 0 0 0 0 0 0 0 0 0 0 0 0 0 0 0 0 
2 1 3 1 0 0 0 0 0 0 0 0 0 0 0 0 0 
1 -1 1 -1 0 0 0 0 0 0 0 0 0 0 0 0 0 
1 0 0 0 0 0 0 0 0 0 0 0 0 0 0 0 0 
0 0 0 0 0 0 0 0 0 0 0 0 0 0 0 0 0 
1 -1 1 -1 0 0 0 0 0 0 0 0 0 0 0 0 0 
1 0 0 0 0 0 0 0 0 0 0 0 0 0 0 0 0 
