6 1 -5 1 0 0 0 0 0 0 0 0 0 0 0 0 0 
4 1 1 5 2 -1 -8 5 0 0 0 0 0 0 0 0 0 
3 1 1 -1 0 0 0 0 0 0 0 0 0 0 0 0 0 
5 -1 3 1 2 -1 -4 -5 8 0 0 0 0 0 0 0 0 
6 1 1 -1 0 0 0 0 0 0 0 0 0 0 0 0 0 
4 1 2 -1 -2 0 0 0 0 0 0 0 0 0 0 0 0 
6 1 1 -1 -1 0 0 0 0 0 0 0 0 0 0 0 0 
4 1 -1 -2 0 0 0 0 0 0 0 0 0 0 0 0 0 
2 -2 1 -1 -1 4 2 0 0 0 0 0 0 0 0 0 0 
7 1 -3 -1 5 4 -8 -1 1 -1 1 0 0 0 0 0 0 
8 -2 1 1 5 2 2 0 0 0 0 0 0 0 0 0 0 
8 -1 2 -1 1 -2 -4 -5 -1 13 6 0 0 0 0 0 0 
7 1 -1 -1 1 0 0 0 0 0 0 0 0 0 0 0 0 
4 2 -1 1 0 0 0 0 0 0 0 0 0 0 0 0 0 
7 1 1 -1 -3 -5 1 -1 -6 0 0 0 0 0 0 0 0 
5 -1 5 1 -1 1 0 0 0 0 0 0 0 0 0 0 0 
-2 1 -1 1 0 0 0 0 0 0 0 0 0 0 0 0 0 
-2 0 0 0 0 0 0 0 0 0 0 0 0 0 0 0 0 
