0 -2 -1 -4 -3 2 -42 0 0 0 0 0 0 0 0 0 0 
6 -1 -1 2 -2 -4 2 4 0 0 0 0 0 0 0 0 0 
6 1 -1 2 0 0 0 0 0 0 0 0 0 0 0 0 0 
5 1 -1 -1 -1 -1 1 -1 1 3 0 0 0 0 0 0 0 
7 1 1 -2 -4 -2 7 0 0 0 0 0 0 0 0 0 0 
6 -1 1 -1 -1 -3 2 3 1 0 0 0 0 0 0 0 0 
8 -1 -2 -1 1 1 0 0 0 0 0 0 0 0 0 0 0 
7 1 -2 1 1 -3 -2 1 0 0 0 0 0 0 0 0 0 
3 1 -1 1 0 0 0 0 0 0 0 0 0 0 0 0 0 
5 -1 1 2 1 -6 1 -2 -2 10 0 0 0 0 0 0 0 
1 1 1 2 -1 0 0 0 0 0 0 0 0 0 0 0 0 
7 1 -1 -3 -1 5 5 -1 -4 -4 8 0 0 0 0 0 0 
7 -2 1 -1 1 0 0 0 0 0 0 0 0 0 0 0 0 
6 1 -1 -1 1 -1 2 1 -1 -1 -5 8 0 0 0 0 0 
7 1 -2 1 -1 -1 -1 3 0 0 0 0 0 0 0 0 0 
9 2 -2 1 -8 -1 -2 1 0 0 0 0 0 0 0 0 0 
-2 4 1 1 0 0 0 0 0 0 0 0 0 0 0 0 0 
-2 -2 -1 -1 0 0 0 0 0 0 0 0 0 0 0 0 0 
