8 -1 2 -4 -5 -3 15 4 3 5 -9 -2 -2 -4 0 0 0 
8 -1 1 2 -1 -1 4 0 0 0 0 0 0 0 0 0 0 
6 1 1 1 -1 -2 -1 -2 2 0 0 0 0 0 0 0 0 
8 1 1 1 -2 4 -7 3 0 0 0 0 0 0 0 0 0 
8 -1 -1 -1 -1 1 3 -2 1 0 0 0 0 0 0 0 0 
8 2 1 1 1 2 -1 -5 -2 -4 2 2 0 0 0 0 0 
11 -4 6 1 0 0 0 0 0 0 0 0 0 0 0 0 0 
10 -1 -1 1 -1 -2 -1 3 3 -4 4 0 0 0 0 0 0 
6 2 -1 -1 -5 1 0 0 0 0 0 0 0 0 0 0 0 
6 1 1 1 -3 -2 1 -2 5 0 0 0 0 0 0 0 0 
8 -1 2 1 2 -4 0 0 0 0 0 0 0 0 0 0 0 
9 1 -1 -2 3 1 4 5 0 0 0 0 0 0 0 0 0 
6 -2 -1 1 -2 7 -2 4 2 4 0 0 0 0 0 0 0 
8 -1 -2 2 -1 1 -6 5 0 0 0 0 0 0 0 0 0 
6 1 -1 1 1 1 -2 -1 1 -1 -2 -2 -1 3 0 0 0 
8 1 1 2 2 2 2 5 7 6 0 0 0 0 0 0 0 
11 -1 -1 2 6 1 0 0 0 0 0 0 0 0 0 0 0 
-2 1 1 1 0 0 0 0 0 0 0 0 0 0 0 0 0 
-2 0 0 0 0 0 0 0 0 0 0 0 0 0 0 0 0 
