5 1 -1 -1 -3 2 3 -1 -3 8 0 0 0 0 0 0 0 
9 -1 1 -2 2 2 6 -10 0 0 0 0 0 0 0 0 0 
7 -1 -2 -1 1 4 3 -2 0 0 0 0 0 0 0 0 0 
7 1 -2 -2 -1 1 2 2 0 0 0 0 0 0 0 0 0 
7 1 -1 3 -3 1 0 0 0 0 0 0 0 0 0 0 0 
5 -1 1 2 -1 0 0 0 0 0 0 0 0 0 0 0 0 
6 2 1 -1 1 -2 -4 -2 10 0 0 0 0 0 0 0 0 
6 -1 2 -1 1 1 0 0 0 0 0 0 0 0 0 0 0 
5 -1 -2 -1 2 0 0 0 0 0 0 0 0 0 0 0 0 
6 1 1 -1 -2 -1 1 4 0 0 0 0 0 0 0 0 0 
5 -1 -1 1 1 2 1 -1 -2 -1 0 0 0 0 0 0 0 
8 1 1 -1 1 1 0 0 0 0 0 0 0 0 0 0 0 
8 1 1 -1 -1 1 3 0 0 0 0 0 0 0 0 0 0 
6 1 1 -1 1 0 0 0 0 0 0 0 0 0 0 0 0 
6 1 1 1 -1 0 0 0 0 0 0 0 0 0 0 0 0 
4 -1 1 1 2 2 -3 -2 0 0 0 0 0 0 0 0 0 
-2 1 1 -3 0 0 0 0 0 0 0 0 0 0 0 0 0 
-2 0 0 0 0 0 0 0 0 0 0 0 0 0 0 0 0 
1 0 0 0 0 0 0 0 0 0 0 0 0 0 0 0 0 
0 0 0 0 0 0 0 0 0 0 0 0 0 0 0 0 0 
0 1 -1 -1 0 0 0 0 0 0 0 0 0 0 0 0 0 
1 0 0 0 0 0 0 0 0 0 0 0 0 0 0 0 0 
0 0 0 0 0 0 0 0 0 0 0 0 0 0 0 0 0 
0 0 0 0 0 0 0 0 0 0 0 0 0 0 0 0 0 
0 0 0 0 0 0 0 0 0 0 0 0 0 0 0 0 0 
0 0 0 0 0 0 0 0 0 0 0 0 0 0 0 0 0 
