5 1 1 -1 0 0 0 0 0 0 0 0 0 0 0 0 0 
4 -1 1 1 -1 -2 -1 -1 0 0 0 0 0 0 0 0 0 
4 -1 1 1 -1 -2 0 0 0 0 0 0 0 0 0 0 0 
6 1 1 -1 -2 0 0 0 0 0 0 0 0 0 0 0 0 
8 -1 1 2 -3 0 0 0 0 0 0 0 0 0 0 0 0 
3 -1 1 -1 0 0 0 0 0 0 0 0 0 0 0 0 0 
4 1 1 -1 -1 -2 0 0 0 0 0 0 0 0 0 0 0 
4 1 -2 -1 0 0 0 0 0 0 0 0 0 0 0 0 0 
5 2 1 1 -1 -2 0 0 0 0 0 0 0 0 0 0 0 
5 -3 -1 1 0 0 0 0 0 0 0 0 0 0 0 0 0 
4 -1 -1 1 1 1 1 -7 -3 11 0 0 0 0 0 0 0 
6 1 1 -2 -3 1 -3 -3 -2 2 -3 3 0 0 0 0 0 
4 1 -1 1 1 -4 0 0 0 0 0 0 0 0 0 0 0 
4 -1 -1 1 0 0 0 0 0 0 0 0 0 0 0 0 0 
8 -1 1 -1 -1 1 2 4 -5 0 0 0 0 0 0 0 0 
5 2 -1 1 -2 -1 -3 4 -4 2 7 0 0 0 0 0 0 
-2 -1 1 1 0 0 0 0 0 0 0 0 0 0 0 0 0 
-2 0 0 0 0 0 0 0 0 0 0 0 0 0 0 0 0 
