11 -1 1 1 1 4 -2 -1 -8 0 0 0 0 0 0 0 0 
8 1 -1 3 -1 -2 1 -2 1 0 0 0 0 0 0 0 0 
6 -1 1 -1 -2 0 0 0 0 0 0 0 0 0 0 0 0 
6 -1 1 1 1 -1 -1 -1 0 0 0 0 0 0 0 0 0 
8 1 -1 -1 1 2 -1 2 -2 1 -4 0 0 0 0 0 0 
10 1 -1 -1 1 3 -4 2 -3 0 0 0 0 0 0 0 0 
9 -2 -2 3 2 1 -4 -1 0 0 0 0 0 0 0 0 0 
8 -1 -1 1 3 -2 -1 1 1 1 0 0 0 0 0 0 0 
5 1 -5 -1 5 0 0 0 0 0 0 0 0 0 0 0 0 
6 -1 2 -1 -1 0 0 0 0 0 0 0 0 0 0 0 0 
4 -1 3 1 4 0 0 0 0 0 0 0 0 0 0 0 0 
4 -1 1 1 3 1 3 0 0 0 0 0 0 0 0 0 0 
6 -1 -1 1 1 -2 1 -1 1 2 0 0 0 0 0 0 0 
9 1 2 -4 -2 -5 0 0 0 0 0 0 0 0 0 0 0 
8 1 3 -2 -1 -3 0 0 0 0 0 0 0 0 0 0 0 
5 -1 1 -1 -2 2 -1 1 2 2 0 0 0 0 0 0 0 
-2 -1 -3 1 0 0 0 0 0 0 0 0 0 0 0 0 0 
-2 1 -1 -1 0 0 0 0 0 0 0 0 0 0 0 0 0 
0 0 0 0 0 0 0 0 0 0 0 0 0 0 0 0 0 
0 0 0 0 0 0 0 0 0 0 0 0 0 0 0 0 0 
1 0 0 0 0 0 0 0 0 0 0 0 0 0 0 0 0 
0 -1 -1 -1 0 0 0 0 0 0 0 0 0 0 0 0 0 
1 0 0 0 0 0 0 0 0 0 0 0 0 0 0 0 0 
0 0 0 0 0 0 0 0 0 0 0 0 0 0 0 0 0 
0 0 0 0 0 0 0 0 0 0 0 0 0 0 0 0 0 
0 0 0 0 0 0 0 0 0 0 0 0 0 0 0 0 0 
