2 4 1 1 0 0 0 0 0 0 0 0 0 0 0 0 0 
2 1 1 -1 -3 0 0 0 0 0 0 0 0 0 0 0 0 
1 1 -1 1 -1 -1 1 0 0 0 0 0 0 0 0 0 0 
5 1 -1 1 0 0 0 0 0 0 0 0 0 0 0 0 0 
3 1 -1 1 0 0 0 0 0 0 0 0 0 0 0 0 0 
3 -2 2 -2 0 0 0 0 0 0 0 0 0 0 0 0 0 
2 1 1 -2 -1 4 0 0 0 0 0 0 0 0 0 0 0 
4 2 2 -1 -3 1 0 0 0 0 0 0 0 0 0 0 0 
7 -1 -1 2 -1 3 -2 3 4 -3 -2 8 0 0 0 0 0 
7 -1 -1 -2 1 -2 3 4 -5 -2 0 0 0 0 0 0 0 
7 -1 -1 -1 -1 -4 -2 0 0 0 0 0 0 0 0 0 0 
8 1 -1 3 1 -3 0 0 0 0 0 0 0 0 0 0 0 
7 1 -1 2 1 -1 -2 6 0 0 0 0 0 0 0 0 0 
6 1 -1 1 0 0 0 0 0 0 0 0 0 0 0 0 0 
6 -2 1 1 -4 2 -3 2 1 1 -2 0 0 0 0 0 0 
6 -1 -1 1 1 -2 -3 0 0 0 0 0 0 0 0 0 0 
-2 -1 1 -1 0 0 0 0 0 0 0 0 0 0 0 0 0 
-2 -1 1 1 0 0 0 0 0 0 0 0 0 0 0 0 0 
0 0 0 0 0 0 0 0 0 0 0 0 0 0 0 0 0 
0 0 0 0 0 0 0 0 0 0 0 0 0 0 0 0 0 
0 -1 1 -1 0 0 0 0 0 0 0 0 0 0 0 0 0 
1 0 0 0 0 0 0 0 0 0 0 0 0 0 0 0 0 
0 0 0 0 0 0 0 0 0 0 0 0 0 0 0 0 0 
0 0 0 0 0 0 0 0 0 0 0 0 0 0 0 0 0 
1 -1 1 -1 0 0 0 0 0 0 0 0 0 0 0 0 0 
1 0 0 0 0 0 0 0 0 0 0 0 0 0 0 0 0 
