3 -1 1 1 -1 -2 0 0 0 0 0 0 0 0 0 0 0 
6 1 1 -1 -1 5 -2 -1 0 0 0 0 0 0 0 0 0 
4 1 -1 -1 -1 -1 3 3 0 0 0 0 0 0 0 0 0 
7 -1 1 1 1 0 0 0 0 0 0 0 0 0 0 0 0 
6 -1 -1 1 2 0 0 0 0 0 0 0 0 0 0 0 0 
7 -1 1 -2 0 0 0 0 0 0 0 0 0 0 0 0 0 
4 -1 1 1 -1 -2 0 0 0 0 0 0 0 0 0 0 0 
4 -2 1 1 1 -1 -4 0 0 0 0 0 0 0 0 0 0 
7 1 -2 -1 -2 0 0 0 0 0 0 0 0 0 0 0 0 
4 -1 -1 1 1 -1 0 0 0 0 0 0 0 0 0 0 0 
4 1 1 -1 -1 -1 0 0 0 0 0 0 0 0 0 0 0 
5 -1 -1 2 -2 0 0 0 0 0 0 0 0 0 0 0 0 
5 -1 -1 2 1 2 1 -6 0 0 0 0 0 0 0 0 0 
7 -1 1 -1 0 0 0 0 0 0 0 0 0 0 0 0 0 
6 2 1 -4 -2 1 5 0 0 0 0 0 0 0 0 0 0 
4 -1 1 1 2 3 -1 -3 0 0 0 0 0 0 0 0 0 
-2 1 -1 1 0 0 0 0 0 0 0 0 0 0 0 0 0 
-2 1 -1 -1 0 0 0 0 0 0 0 0 0 0 0 0 0 
