9 -1 2 -1 1 -1 2 -3 -1 0 0 0 0 0 0 0 0 
8 -1 1 -2 3 -2 -4 7 -1 4 0 0 0 0 0 0 0 
9 1 -2 -3 1 -2 -2 0 0 0 0 0 0 0 0 0 0 
8 2 2 -2 -1 -1 3 -2 -1 -4 8 0 0 0 0 0 0 
6 -1 -1 -2 0 0 0 0 0 0 0 0 0 0 0 0 0 
3 -1 1 -1 0 0 0 0 0 0 0 0 0 0 0 0 0 
7 -1 3 -3 -1 4 -1 -1 -2 -4 1 7 0 0 0 0 0 
6 1 -1 1 0 0 0 0 0 0 0 0 0 0 0 0 0 
8 -1 -1 1 1 7 1 -2 -8 0 0 0 0 0 0 0 0 
9 -1 -1 -1 3 -1 2 -1 1 -3 6 0 0 0 0 0 0 
9 1 -1 -1 4 -1 2 -1 1 -5 0 0 0 0 0 0 0 
10 1 1 1 2 -1 5 3 -1 1 -2 0 0 0 0 0 0 
11 -1 1 -1 3 -4 1 -2 -1 3 -3 -3 1 2 0 0 0 
7 -1 2 -1 1 2 -4 -8 -1 0 0 0 0 0 0 0 0 
12 -1 -1 2 1 -4 -1 1 0 0 0 0 0 0 0 0 0 
8 3 -2 -1 0 0 0 0 0 0 0 0 0 0 0 0 0 
-2 1 -2 -1 0 0 0 0 0 0 0 0 0 0 0 0 0 
-2 0 0 0 0 0 0 0 0 0 0 0 0 0 0 0 0 
0 0 0 0 0 0 0 0 0 0 0 0 0 0 0 0 0 
0 0 0 0 0 0 0 0 0 0 0 0 0 0 0 0 0 
0 0 0 0 0 0 0 0 0 0 0 0 0 0 0 0 0 
0 0 0 0 0 0 0 0 0 0 0 0 0 0 0 0 0 
0 0 0 0 0 0 0 0 0 0 0 0 0 0 0 0 0 
0 0 0 0 0 0 0 0 0 0 0 0 0 0 0 0 0 
0 -1 1 -1 0 0 0 0 0 0 0 0 0 0 0 0 0 
1 -1 1 -1 0 0 0 0 0 0 0 0 0 0 0 0 0 
