6 1 2 -1 1 -2 -1 -6 0 0 0 0 0 0 0 0 0 
5 0 0 0 0 0 0 0 0 0 0 0 0 0 0 0 0 
8 1 2 1 -2 -3 4 1 2 -7 -3 10 0 0 0 0 0 
6 -2 1 -1 -3 -1 -3 6 -4 6 -1 5 -5 0 0 0 0 
1 1 1 -1 0 0 0 0 0 0 0 0 0 0 0 0 0 
3 -1 1 2 0 0 0 0 0 0 0 0 0 0 0 0 0 
8 1 -2 2 -2 1 -1 4 -7 -2 -6 -2 10 11 0 0 0 
8 1 -2 2 2 -1 1 -2 0 0 0 0 0 0 0 0 0 
10 -1 1 -1 1 -3 4 1 8 2 1 -5 5 -3 0 0 0 
13 -1 1 -1 3 3 -3 5 1 -1 -7 -1 6 0 0 0 0 
9 1 -1 1 2 1 -2 -1 0 0 0 0 0 0 0 0 0 
10 1 -1 1 -3 -7 0 0 0 0 0 0 0 0 0 0 0 
13 1 -2 1 -7 2 -2 2 1 2 1 1 -5 0 0 0 0 
10 -1 1 -1 -2 -2 2 5 -1 -1 -7 0 0 0 0 0 0 
9 -1 -1 -1 0 0 0 0 0 0 0 0 0 0 0 0 0 
6 0 0 0 0 0 0 0 0 0 0 0 0 0 0 0 0 
-2 1 1 -1 0 0 0 0 0 0 0 0 0 0 0 0 0 
-2 -1 -1 1 0 0 0 0 0 0 0 0 0 0 0 0 0 
1 -1 1 -1 0 0 0 0 0 0 0 0 0 0 0 0 0 
1 -1 1 -1 0 0 0 0 0 0 0 0 0 0 0 0 0 
1 1 1 -1 0 0 0 0 0 0 0 0 0 0 0 0 0 
1 1 1 -1 0 0 0 0 0 0 0 0 0 0 0 0 0 
0 1 1 -1 0 0 0 0 0 0 0 0 0 0 0 0 0 
1 0 0 0 0 0 0 0 0 0 0 0 0 0 0 0 0 
1 -1 -1 -1 0 0 0 0 0 0 0 0 0 0 0 0 0 
1 0 0 0 0 0 0 0 0 0 0 0 0 0 0 0 0 
