4 -1 1 1 0 0 0 0 0 0 0 0 0 0 0 0 0 
6 -1 1 1 -1 1 1 -6 -3 -1 16 0 0 0 0 0 0 
2 -1 -1 1 -5 1 4 0 0 0 0 0 0 0 0 0 0 
8 -1 1 -2 -2 2 2 1 0 0 0 0 0 0 0 0 0 
9 1 1 -1 1 -2 -3 1 -2 6 4 0 0 0 0 0 0 
9 1 1 -1 0 0 0 0 0 0 0 0 0 0 0 0 0 
9 -3 1 -1 -1 2 4 -4 1 0 0 0 0 0 0 0 0 
5 1 2 -3 -1 0 0 0 0 0 0 0 0 0 0 0 0 
6 1 1 1 -1 -1 7 0 0 0 0 0 0 0 0 0 0 
7 -1 -2 1 0 0 0 0 0 0 0 0 0 0 0 0 0 
6 2 6 -2 -13 0 0 0 0 0 0 0 0 0 0 0 0 
4 -1 1 -1 1 -1 0 0 0 0 0 0 0 0 0 0 0 
6 1 -1 -1 -1 -1 -1 -1 0 0 0 0 0 0 0 0 0 
6 1 1 -3 3 0 0 0 0 0 0 0 0 0 0 0 0 
6 1 -1 1 -2 0 0 0 0 0 0 0 0 0 0 0 0 
4 1 -1 1 -1 2 5 0 0 0 0 0 0 0 0 0 0 
-2 3 -6 -1 0 0 0 0 0 0 0 0 0 0 0 0 0 
-2 -1 1 1 0 0 0 0 0 0 0 0 0 0 0 0 0 
0 1 1 -1 0 0 0 0 0 0 0 0 0 0 0 0 0 
1 0 0 0 0 0 0 0 0 0 0 0 0 0 0 0 0 
2 0 0 0 0 0 0 0 0 0 0 0 0 0 0 0 0 
0 1 1 -1 0 0 0 0 0 0 0 0 0 0 0 0 0 
0 0 0 0 0 0 0 0 0 0 0 0 0 0 0 0 0 
0 0 0 0 0 0 0 0 0 0 0 0 0 0 0 0 0 
0 0 0 0 0 0 0 0 0 0 0 0 0 0 0 0 0 
0 0 0 0 0 0 0 0 0 0 0 0 0 0 0 0 0 
