10 1 -2 3 -2 4 -3 1 3 2 6 -8 -1 7 10 0 0 
10 -1 -1 1 1 1 0 0 0 0 0 0 0 0 0 0 0 
7 -1 -1 -1 -1 -1 -1 -3 -2 0 0 0 0 0 0 0 0 
9 -1 -1 -1 -1 0 0 0 0 0 0 0 0 0 0 0 0 
6 -1 -2 1 0 0 0 0 0 0 0 0 0 0 0 0 0 
7 1 -1 -1 2 0 0 0 0 0 0 0 0 0 0 0 0 
5 2 1 -2 -1 -2 5 0 0 0 0 0 0 0 0 0 0 
4 1 1 1 0 0 0 0 0 0 0 0 0 0 0 0 0 
4 1 1 -1 -2 -1 -3 0 0 0 0 0 0 0 0 0 0 
5 -1 2 -1 0 0 0 0 0 0 0 0 0 0 0 0 0 
3 -1 -1 1 -1 0 0 0 0 0 0 0 0 0 0 0 0 
6 1 1 -1 -1 0 0 0 0 0 0 0 0 0 0 0 0 
4 -1 1 1 1 1 0 0 0 0 0 0 0 0 0 0 0 
3 -1 -2 -1 0 0 0 0 0 0 0 0 0 0 0 0 0 
4 -1 -1 1 2 1 1 2 0 0 0 0 0 0 0 0 0 
4 -1 -1 -1 0 0 0 0 0 0 0 0 0 0 0 0 0 
5 1 1 -1 0 0 0 0 0 0 0 0 0 0 0 0 0 
-2 -1 -2 -1 0 0 0 0 0 0 0 0 0 0 0 0 0 
-2 0 0 0 0 0 0 0 0 0 0 0 0 0 0 0 0 
0 0 0 0 0 0 0 0 0 0 0 0 0 0 0 0 0 
0 0 0 0 0 0 0 0 0 0 0 0 0 0 0 0 0 
0 0 0 0 0 0 0 0 0 0 0 0 0 0 0 0 0 
0 -1 -1 -1 0 0 0 0 0 0 0 0 0 0 0 0 0 
0 0 0 0 0 0 0 0 0 0 0 0 0 0 0 0 0 
0 0 0 0 0 0 0 0 0 0 0 0 0 0 0 0 0 
0 0 0 0 0 0 0 0 0 0 0 0 0 0 0 0 0 
0 0 0 0 0 0 0 0 0 0 0 0 0 0 0 0 0 
