2 1 1 -1 0 0 0 0 0 0 0 0 0 0 0 0 0 
3 1 1 -1 0 0 0 0 0 0 0 0 0 0 0 0 0 
7 1 -1 2 1 -1 1 -1 0 0 0 0 0 0 0 0 0 
4 1 1 1 0 0 0 0 0 0 0 0 0 0 0 0 0 
1 -1 1 1 0 0 0 0 0 0 0 0 0 0 0 0 0 
1 1 -1 -1 2 0 0 0 0 0 0 0 0 0 0 0 0 
2 -1 -1 1 0 0 0 0 0 0 0 0 0 0 0 0 0 
4 -2 1 -1 0 0 0 0 0 0 0 0 0 0 0 0 0 
9 1 1 -3 1 1 2 -1 -2 -1 2 -1 7 1 0 0 0 
8 1 -1 -1 0 0 0 0 0 0 0 0 0 0 0 0 0 
10 2 -2 2 2 -3 3 2 4 -7 2 0 0 0 0 0 0 
6 -2 1 -2 2 -1 1 1 2 0 0 0 0 0 0 0 0 
3 -1 1 -1 1 0 0 0 0 0 0 0 0 0 0 0 0 
3 -1 -2 -1 0 0 0 0 0 0 0 0 0 0 0 0 0 
6 1 2 -1 0 0 0 0 0 0 0 0 0 0 0 0 0 
3 1 -1 -2 0 0 0 0 0 0 0 0 0 0 0 0 0 
-2 1 1 -1 0 0 0 0 0 0 0 0 0 0 0 0 0 
-2 0 0 0 0 0 0 0 0 0 0 0 0 0 0 0 0 
