4 -1 1 2 -1 2 -4 3 0 0 0 0 0 0 0 0 0 
7 1 1 2 -3 -3 0 0 0 0 0 0 0 0 0 0 0 
6 -1 1 1 1 0 0 0 0 0 0 0 0 0 0 0 0 
5 -1 1 1 -1 -1 0 0 0 0 0 0 0 0 0 0 0 
5 1 -1 -2 3 1 1 -2 -2 0 0 0 0 0 0 0 0 
8 1 1 -2 2 3 -8 -2 -4 -3 3 17 0 0 0 0 0 
7 1 2 1 2 0 0 0 0 0 0 0 0 0 0 0 0 
8 -1 -1 1 1 0 0 0 0 0 0 0 0 0 0 0 0 
4 1 -1 1 1 -1 -1 1 0 0 0 0 0 0 0 0 0 
6 1 2 -2 -1 -1 -4 1 1 -1 3 0 0 0 0 0 0 
7 -1 -2 -1 -1 1 3 0 0 0 0 0 0 0 0 0 0 
8 1 -1 3 2 0 0 0 0 0 0 0 0 0 0 0 0 
7 1 -2 1 1 6 0 0 0 0 0 0 0 0 0 0 0 
5 -2 1 -2 1 2 1 0 0 0 0 0 0 0 0 0 0 
5 1 -2 1 2 -3 -1 0 0 0 0 0 0 0 0 0 0 
6 -3 3 -2 1 0 0 0 0 0 0 0 0 0 0 0 0 
-2 -1 -1 5 0 0 0 0 0 0 0 0 0 0 0 0 0 
-2 0 0 0 0 0 0 0 0 0 0 0 0 0 0 0 0 
0 0 0 0 0 0 0 0 0 0 0 0 0 0 0 0 0 
0 0 0 0 0 0 0 0 0 0 0 0 0 0 0 0 0 
0 -1 -1 1 0 0 0 0 0 0 0 0 0 0 0 0 0 
1 1 -1 -1 0 0 0 0 0 0 0 0 0 0 0 0 0 
0 0 0 0 0 0 0 0 0 0 0 0 0 0 0 0 0 
0 1 1 -1 0 0 0 0 0 0 0 0 0 0 0 0 0 
0 0 0 0 0 0 0 0 0 0 0 0 0 0 0 0 0 
1 0 0 0 0 0 0 0 0 0 0 0 0 0 0 0 0 
