3 5 -4 7 -4 13 -3 3 1 -5 -14 5 -21 15 -2 -38 0 
3 -1 -1 -1 -1 1 6 0 0 0 0 0 0 0 0 0 0 
5 -1 -1 -3 -1 -1 2 -2 -1 0 0 0 0 0 0 0 0 
5 -1 1 2 0 0 0 0 0 0 0 0 0 0 0 0 0 
6 -1 -1 -1 1 -4 -1 -5 5 4 6 4 0 0 0 0 0 
8 2 4 1 7 0 0 0 0 0 0 0 0 0 0 0 0 
6 -1 -1 -2 1 1 -1 1 2 -3 0 0 0 0 0 0 0 
8 -1 -1 2 -2 1 3 4 7 6 3 -3 5 0 0 0 0 
11 1 1 -4 -2 1 -3 3 -2 -1 -3 0 0 0 0 0 0 
4 -1 2 1 -1 0 0 0 0 0 0 0 0 0 0 0 0 
8 -1 1 5 -1 -4 6 1 -3 2 0 0 0 0 0 0 0 
5 1 1 -2 0 0 0 0 0 0 0 0 0 0 0 0 0 
6 1 2 -3 0 0 0 0 0 0 0 0 0 0 0 0 0 
11 1 1 1 4 5 2 1 -4 -3 0 0 0 0 0 0 0 
10 1 -2 1 -1 2 -3 -1 -2 6 -7 0 0 0 0 0 0 
6 1 -2 -1 0 0 0 0 0 0 0 0 0 0 0 0 0 
6 -2 -1 1 0 0 0 0 0 0 0 0 0 0 0 0 0 
-2 2 -1 -1 0 0 0 0 0 0 0 0 0 0 0 0 0 
-2 1 1 1 0 0 0 0 0 0 0 0 0 0 0 0 0 
