4 1 1 -1 1 -1 1 -1 2 0 0 0 0 0 0 0 0 
9 -1 -1 1 6 0 0 0 0 0 0 0 0 0 0 0 0 
5 1 1 -3 1 0 0 0 0 0 0 0 0 0 0 0 0 
4 1 -1 1 1 0 0 0 0 0 0 0 0 0 0 0 0 
5 -1 -1 1 1 1 1 -4 -9 4 0 0 0 0 0 0 0 
7 -1 -1 1 1 0 0 0 0 0 0 0 0 0 0 0 0 
7 1 1 1 -1 -1 -2 -2 -4 -2 2 2 7 0 0 0 0 
8 -1 1 2 -1 1 0 0 0 0 0 0 0 0 0 0 0 
4 1 -1 -1 1 -2 0 0 0 0 0 0 0 0 0 0 0 
5 -1 -1 1 2 -3 2 1 -2 -1 1 0 0 0 0 0 0 
5 1 -1 1 0 0 0 0 0 0 0 0 0 0 0 0 0 
6 1 1 2 -1 -3 -4 3 5 -8 -4 7 0 0 0 0 0 
11 1 -1 1 -1 3 -3 -2 1 -1 -3 0 0 0 0 0 0 
8 1 -1 1 4 0 0 0 0 0 0 0 0 0 0 0 0 
11 1 -2 -1 -4 3 -4 5 1 -3 0 0 0 0 0 0 0 
7 2 1 -1 0 0 0 0 0 0 0 0 0 0 0 0 0 
