8 3 -4 3 -2 -5 5 2 -7 -8 14 21 4 -3 0 0 0 
8 2 -3 3 -2 1 -2 0 0 0 0 0 0 0 0 0 0 
7 2 4 -3 1 7 0 0 0 0 0 0 0 0 0 0 0 
8 -1 -1 -3 2 -3 0 0 0 0 0 0 0 0 0 0 0 
5 -1 1 -2 4 5 5 -2 -5 4 3 0 0 0 0 0 0 
8 1 -1 1 -2 5 -1 -2 2 -8 0 0 0 0 0 0 0 
11 1 1 1 -2 3 -1 0 0 0 0 0 0 0 0 0 0 
10 -1 -1 2 -3 2 1 -7 0 0 0 0 0 0 0 0 0 
7 -1 2 2 1 -1 -2 -1 1 0 0 0 0 0 0 0 0 
8 -1 -1 -1 1 -1 5 -2 2 1 2 2 4 -9 4 0 0 
12 1 1 7 4 -1 3 -5 1 -4 -6 0 0 0 0 0 0 
8 -1 1 1 0 0 0 0 0 0 0 0 0 0 0 0 0 
7 -1 -1 -1 0 0 0 0 0 0 0 0 0 0 0 0 0 
9 1 1 -2 -2 4 -2 2 -3 -2 1 -2 0 0 0 0 0 
10 -1 -1 7 3 2 2 -2 3 -1 0 0 0 0 0 0 0 
7 -1 -2 1 -2 6 0 0 0 0 0 0 0 0 0 0 0 
7 1 -1 -1 -5 -2 0 0 0 0 0 0 0 0 0 0 0 
-2 1 1 1 0 0 0 0 0 0 0 0 0 0 0 0 0 
-2 0 0 0 0 0 0 0 0 0 0 0 0 0 0 0 0 
0 0 0 0 0 0 0 0 0 0 0 0 0 0 0 0 0 
1 0 0 0 0 0 0 0 0 0 0 0 0 0 0 0 0 
0 0 0 0 0 0 0 0 0 0 0 0 0 0 0 0 0 
0 -1 1 -1 0 0 0 0 0 0 0 0 0 0 0 0 0 
0 0 0 0 0 0 0 0 0 0 0 0 0 0 0 0 0 
0 0 0 0 0 0 0 0 0 0 0 0 0 0 0 0 0 
0 0 0 0 0 0 0 0 0 0 0 0 0 0 0 0 0 
0 0 0 0 0 0 0 0 0 0 0 0 0 0 0 0 0 
