3 -1 -1 1 0 0 0 0 0 0 0 0 0 0 0 0 0 
3 -1 -1 1 0 0 0 0 0 0 0 0 0 0 0 0 0 
3 1 -1 -2 1 0 0 0 0 0 0 0 0 0 0 0 0 
4 2 -3 1 0 0 0 0 0 0 0 0 0 0 0 0 0 
4 -1 2 1 -2 -1 1 0 0 0 0 0 0 0 0 0 0 
5 -1 1 1 -1 1 -2 -1 2 0 0 0 0 0 0 0 0 
5 -1 1 -2 4 0 0 0 0 0 0 0 0 0 0 0 0 
6 2 1 -1 -3 -2 1 4 2 -2 -1 -2 0 0 0 0 0 
3 1 -1 3 2 0 0 0 0 0 0 0 0 0 0 0 0 
4 1 1 -1 -3 0 0 0 0 0 0 0 0 0 0 0 0 
7 -1 2 -1 1 -2 -1 0 0 0 0 0 0 0 0 0 0 
5 -1 -1 -1 2 1 4 -1 -4 1 0 0 0 0 0 0 0 
4 1 1 1 -4 -4 -4 10 0 0 0 0 0 0 0 0 0 
9 1 -3 -1 10 -3 1 -2 -5 0 0 0 0 0 0 0 0 
8 1 1 1 -2 -2 -1 -1 2 -1 -3 0 0 0 0 0 0 
9 1 5 -1 7 -2 -2 0 0 0 0 0 0 0 0 0 0 
