5 1 1 -3 -2 3 0 0 0 0 0 0 0 0 0 0 0 
5 -1 -1 1 2 2 -7 0 0 0 0 0 0 0 0 0 0 
4 2 -1 1 0 0 0 0 0 0 0 0 0 0 0 0 0 
4 1 -2 -1 0 0 0 0 0 0 0 0 0 0 0 0 0 
6 1 -1 -1 -1 -1 6 0 0 0 0 0 0 0 0 0 0 
6 1 -1 1 -2 4 -4 2 -1 0 0 0 0 0 0 0 0 
5 -1 -1 2 4 0 0 0 0 0 0 0 0 0 0 0 0 
6 -1 -1 -1 3 -3 1 0 0 0 0 0 0 0 0 0 0 
4 -1 2 -1 0 0 0 0 0 0 0 0 0 0 0 0 0 
3 3 1 -1 0 0 0 0 0 0 0 0 0 0 0 0 0 
3 0 0 0 0 0 0 0 0 0 0 0 0 0 0 0 0 
1 1 1 -1 0 0 0 0 0 0 0 0 0 0 0 0 0 
3 1 3 1 0 0 0 0 0 0 0 0 0 0 0 0 0 
5 1 4 1 -3 0 0 0 0 0 0 0 0 0 0 0 0 
2 -1 1 -1 -2 0 0 0 0 0 0 0 0 0 0 0 0 
4 1 1 -1 3 -4 1 -5 4 0 0 0 0 0 0 0 0 
-2 0 0 0 0 0 0 0 0 0 0 0 0 0 0 0 0 
-2 -1 -1 -1 0 0 0 0 0 0 0 0 0 0 0 0 0 
0 0 0 0 0 0 0 0 0 0 0 0 0 0 0 0 0 
0 0 0 0 0 0 0 0 0 0 0 0 0 0 0 0 0 
0 0 0 0 0 0 0 0 0 0 0 0 0 0 0 0 0 
0 1 1 -1 0 0 0 0 0 0 0 0 0 0 0 0 0 
1 0 0 0 0 0 0 0 0 0 0 0 0 0 0 0 0 
0 0 0 0 0 0 0 0 0 0 0 0 0 0 0 0 0 
0 0 0 0 0 0 0 0 0 0 0 0 0 0 0 0 0 
0 0 0 0 0 0 0 0 0 0 0 0 0 0 0 0 0 

