8 -1 1 1 1 -1 -3 -2 1 -1 5 0 0 0 0 0 0 
10 1 1 -1 -2 1 2 -4 0 0 0 0 0 0 0 0 0 
9 1 1 -2 -3 -2 2 3 0 0 0 0 0 0 0 0 0 
7 -1 -1 3 1 -1 0 0 0 0 0 0 0 0 0 0 0 
7 -1 -1 1 3 -2 2 -5 0 0 0 0 0 0 0 0 0 
7 1 2 3 -12 0 0 0 0 0 0 0 0 0 0 0 0 
6 -1 1 1 4 -3 0 0 0 0 0 0 0 0 0 0 0 
5 -1 1 -1 0 0 0 0 0 0 0 0 0 0 0 0 0 
9 2 -1 -2 3 1 -3 2 0 0 0 0 0 0 0 0 0 
6 1 -4 -1 -1 -1 3 0 0 0 0 0 0 0 0 0 0 
7 1 -2 -2 -1 0 0 0 0 0 0 0 0 0 0 0 0 
5 1 1 -1 4 0 0 0 0 0 0 0 0 0 0 0 0 
6 -1 1 -1 -2 0 0 0 0 0 0 0 0 0 0 0 0 
3 -1 -1 1 0 0 0 0 0 0 0 0 0 0 0 0 0 
4 -1 -1 1 1 -1 1 3 3 0 0 0 0 0 0 0 0 
5 -1 1 1 2 1 -1 -1 0 0 0 0 0 0 0 0 0 
-2 1 -1 -1 0 0 0 0 0 0 0 0 0 0 0 0 0 
-2 1 1 1 0 0 0 0 0 0 0 0 0 0 0 0 0 

