4 1 -1 -1 1 -1 -2 4 1 -1 -2 -7 5 0 0 0 0 
12 1 2 3 3 2 -17 0 0 0 0 0 0 0 0 0 0 
7 2 1 1 0 0 0 0 0 0 0 0 0 0 0 0 0 
4 1 1 -1 1 -1 2 2 0 0 0 0 0 0 0 0 0 
6 0 0 0 0 0 0 0 0 0 0 0 0 0 0 0 0 
0 -1 -1 3 0 0 0 0 0 0 0 0 0 0 0 0 0 
4 0 0 0 0 0 0 0 0 0 0 0 0 0 0 0 0 
2 -1 1 1 0 0 0 0 0 0 0 0 0 0 0 0 0 
2 -2 3 1 0 0 0 0 0 0 0 0 0 0 0 0 0 
5 1 1 1 1 3 0 0 0 0 0 0 0 0 0 0 0 
5 1 -1 1 -1 4 2 0 0 0 0 0 0 0 0 0 0 
6 -1 -1 2 2 -1 1 1 1 0 0 0 0 0 0 0 0 
3 1 -1 -1 -1 1 0 0 0 0 0 0 0 0 0 0 0 
3 1 -1 1 1 0 0 0 0 0 0 0 0 0 0 0 0 
7 -1 3 -1 5 -5 2 7 -6 -3 -19 22 0 0 0 0 0 
8 -1 -1 -2 -4 -3 3 3 -2 -6 -1 9 -2 0 0 0 0 
-2 0 0 0 0 0 0 0 0 0 0 0 0 0 0 0 0 
-2 -2 -1 -1 0 0 0 0 0 0 0 0 0 0 0 0 0 
0 0 0 0 0 0 0 0 0 0 0 0 0 0 0 0 0 
0 0 0 0 0 0 0 0 0 0 0 0 0 0 0 0 0 
0 0 0 0 0 0 0 0 0 0 0 0 0 0 0 0 0 
0 -1 1 -1 0 0 0 0 0 0 0 0 0 0 0 0 0 
0 0 0 0 0 0 0 0 0 0 0 0 0 0 0 0 0 
0 1 1 -1 0 0 0 0 0 0 0 0 0 0 0 0 0 
0 0 0 0 0 0 0 0 0 0 0 0 0 0 0 0 0 
1 0 0 0 0 0 0 0 0 0 0 0 0 0 0 0 0 

